libmtkit	libmtkit	1
libmtcelledit	libmtcelledit	1
libmtpixy	libmtpixy	1
libmtcedui	libmtcedui	1
libmtpixyui	libmtpixyui	1
mtcedutils	mtcedutils	1
mtcedcli	mtcedcli	1
mtpixyutils	mtpixyutils	1
mtpixycli	mtpixycli	1
mtnetlog	mtnetlog	1
mtrdc	mtrdc	1
libmtqex5	libmtqex	1
mtcelledit-qt5	mtcelledit	1
mteleana-qt5	mteleana	1
mtraft-qt5	mtraft		1
mtpixy-qt5	mtpixy	1
libmtqex4	libmtqex
mtcelledit-qt4	mtcelledit
mteleana-qt4	mteleana
mtraft-qt4	mtraft
mtpixy-qt4	mtpixy
